0 1 1 1 1 2 1 1 3 4
9 1 8 2 1 1 7 1 6 5
10 11 2 1 1 1 1 1 1 4
9 1 1 1 1 1 1 1 1 5
10 11 2 1 1 1 1 1 1 4
9 1 1 1 1 1 1 1 1 5
10 11 2 1 1 1 1 1 1 4
9 1 1 1 1 1 1 1 1 5
10 11 2 1 1 1 1 1 1 4
9 1 1 1 1 1 1 1 1 5